....#####
....####.
....####.
....####.
.........
..######.
..######.
..######.
.........