....#####
....####.
....####.
....####.
.........
.#######.
.#######.
.#######.
.........